########
# # # S#
# #   ##
# ###  #
#     E#
########
