#####################
# # #  # #  #  # # ##
# #   #    ##    #  #
# ###  # # #### ### #
#        #       #  #
############# ##   ##
#          ##  ###  #
# ##### #  ## ##  #S#
#     # #  #      ###
# ## ## # #######   #
#  # #  #      ## ###
#### ####### ###    #
#E     #         ## #
#####################
